e 1 0 P e 0 P 0 e P 
e 0 P 0 0 e 0 e e 1 
0 1 P 0 C 0 E 0 P P 
0 1 P P e e P P 1 0 
1 1 E 0 e e e 0 e P 
0 K P e 0 0 E e e P 
1 E e e 0 1 p e 0 e 
1 K e P P 1 0 P G p 
e P P P 0 P P 1 E 1 
e P E 0 1 e 1 p 0 1 
