P P P P 1 E 0 1 P K
1 P 1 1 P 0 1 0 E 0 
1 0 1 P e 0 P 1 0 e 
P 1 1 P P P P P 0 E 
1 1 P 0 E C E 0 E 1 
P 1 P P E 0 1 K 0 0 
p 0 1 1 1 P P E P P 
e 0 1 P P 1 G 1 1 1 
P 1 1 0 p E 0 e 0 0 
P 0 E E 1 1 1 P 1 0
